1111111111121111111111111
1000100000001010000000101
1010101111111010111110101
1010101000001000100010101
1011101011101111101010101
1000100010001000001000001
1010111110111011111011101
1010000010100010001010001
1011111110101110111011101
1000100000100010000010001
1110101110111110111110111
1000000010100010000010001
1011111110101011111110101
1000100000101000000010101
1110111010101111101010101
1010001010101000001010101
1011101110101011111010111
1000101000101010000010001
1011101011111010111111101
1010001010100010100000001
1010111010101010101011101
1010100010001010001000101
1010101111111111111110101
1000100000000000000000101
1111111111111211111111111